141222111111
100101000001
102200011101
101001000101
100000011101
102201001001
200000011101
101111000001
100000011101
201101010101
100000000001
122111211211